OOOOOOOOOH
OHHHHHOHOH
GOOOOHOHOH
HHHHHHOHOH
OOOOOOOHOH
OHHHHHHHOH
OHOOOOOHOH
OHHHOHOHOH
SOOHOHOOOH
HHHHHHHHHH
